R 1920 1080

NO ./textures/bluestone.xpm
SO ./textures/eagle.xpm
WE ./textures/greystone.xpm
EA ./textures/redbrick.xpm
S ./textures/pillar.xpm

F 91,91,91
C 21,21,21

11111111111111
10000000000001
10000000000001
10000000000001
100000W0000001
10000000000001
10000000000001
10000000000001
10000000000001
11111111111111
