R 1920 1080

NO ./textures/Wall1.xpm
SO ./textures/Wall2.xpm
WE ./textures/Wall3.xpm
EA ./textures/Wall4.xpm
S ./textures/Mr_Game_and_Watch_Hammer.xpm

F 255,255,255
C 0,0,0

1111111111111111
10000001100N0211
1000000100100111
1002000100100111
1000001101110111
1000001001111111
1000000001111111
1111111111111111
