R 1000 1000

NO ./textures/Wall1.xpm
SO ./textures/Wall2.xpm
WE ./textures/Wall3.xpm
EA ./textures/Wall4.xpm
S ./textures/Mr_Game_and_Watch_Hammer.xpm

C 0,0,0
F 255,255,255

1111111111111111
1000000000000001
1000001001000201
1012100101100001
1001000000001001
1000111110000001
1000002020010001
1000000200000001
1000000000001001
1000100N00010001
1002000000000001
1000000000000201
1000000000000001
1111111111111111
