R 1920 1080

NO ./textures/Wall1.xpm
SO ./textures/Wall2.xpm
WE ./textures/Wall3.xpm
EA ./textures/Wall4.xpm
S ./textures/Mr_Game_and_Watch_Hammer.xpm

F 255,255,255
C 0,0,0

111111111111111111111111111111111111111111111
100000000000000000000000000000000000000000001
100000200000000000000000000000000000000000001
100000000000000000000000000000000000000000001
100000200000000000000000000000000000000000001
100000000000000000000000000000000000000000001
100000200000000000000000000000000000000000001
100000N00000000000000000000000000000000000001
100000000000000000000000000000000000000000001
111111111111111111111111111111111111111111111
