R 1920 1080

NO ./textures/Wall1.xpm
SO ./textures/Wall1.xpm
WE ./textures/Wall2.xpm
EA ./textures/Wall2.xpm
S ./textures/Sprite.xpm

F 255,255,255
C 0,0,0

11111111111111
10000000000001
10000000000001
10000000000001
100000N0000001
10000000000001
10000000000001
10000000000001
10000000000001
11111111111111
