R 1920 1080

NO ./textures/bluestone.xpm
SO ./textures/eagle.xpm
WE ./textures/greystone.xpm
EA ./textures/redbrick.xpm
S ./textures/pillar.xpm

F 91,91,91
C 21,21,21

1111111111111111111111111
1200000000200000002000001
1000200001111111000000101
1000000001000001000000001
101002000100N001002000001
1000000001110111000000001
1010020000000020000000101
1000000020000000000000001
1111111111111111111111111
