R 1920 1080

NO ./textures/bluestone.xpm
SO ./textures/eagle.xpm
WE ./textures/greystone.xpm
EA ./textures/redbrick.xpm
S ./textures/pillar.xpm

F 91,91,91
C 21,21,21

111111111
100000001
1000W0001
100000001
111111111
